1
20 20
#.##################
#.##################
#..#################
##..################
###..###############
####..##############
#####..#############
######..############
#######..###########
########..##########
#########..#########
##########..########
###########..#######
############..######
#############..#####
##############..####
###############..###
################..##
#################..#
##################.#
